11111111
10000E01
11000001
10000001
10001001
1000P101
10001001
10000011
10000001
10000011
10000001
10000011
10000001
10000011
10000011
10000011
10000011
10000011
10000011
10000011
10000011
10000011
1C1CCCC1
10000001
11111111